{
  "length": "12",
  "height": "8",
  "grid" : {
    "0": [0,0,1,0,0,1,0,1,1,0,1,0],
    "1": [1,0,0,0,0,1,0,0,1,0,1,0],
    "2": [1,0,1,1,1,0,1,0,1,1,1,1],
    "3": [1,0,0,1,0,1,0,0,0,0,0,0],
    "4": [1,0,0,1,0,0,1,0,0,0,1,0],
    "5": [0,0,1,1,1,0,1,1,0,1,0,1],
    "6": [0,0,0,1,1,1,1,1,1,0,0,1],
    "7": [0,1,1,0,1,0,0,1,0,1,1,1]
  }
}